%%%%%%%%%%%%%%%%%%%%%%%
%       %     %  ...%G%
%%% % %%%%% % %%%.%.%.%
% % %.......%   %.%...%
% % %.% %%%.%%% %.%%% %
%.....%   %.......  % %
%.%%% % % % % % %%%%% %
%.% %   % % %       % %
%.% % %%% %%%%% % %%% %
%P  %         % %     %
%%%%%%%%%%%%%%%%%%%%%%%
Path cost: 36.0
Number of Nodes Expanded: 115
Maximum tree Depth searched: 36
Maximum size of the frontier: 6
