%%%%%%%%%%%%%%%%%%%%%%%
%  ...  %  ...%  ...%G%
%%%.%.%%%%%.%.%%%.%.%.%
% %.%.......%...%.%...%
% %.% % %%% %%%.%.%%% %
%...  %   %    ...  % %
%.%%% % % % % % %%%%% %
%.% %   % % %       % %
%.% % %%% %%%%% % %%% %
%P  %         % %     %
%%%%%%%%%%%%%%%%%%%%%%%
Path cost: 44.0
Number of Nodes Expanded: 61
Maximum tree Depth searched: 44
Maximum size of the frontier: 13
