%%%%%%%%%%%%%%%%%%%%%%%
%       %     %     %G%
%%% % %%%%% % %%% % %.%
% % %  .....%   % %  .%
% % % %.%%%.%%% % %%%.%
%.....%...%...      %.%
%.%%%.% %.% %.% %%%%%.%
%.% %.  %.% %.....  %.%
%.% %.%%%.%%%%% %.%%%.%
%P  %.....    % %.....%
%%%%%%%%%%%%%%%%%%%%%%%
Path cost: 52.0
Number of Nodes Expanded: 77
Maximum tree Depth searched: 52
Maximum size of the frontier: 11
